------------------------------------------------------------------------------------------------------------------------
------------------------------------------------------------------------------------------------------------------------
------------------------------------------------------------------------------------------------------------------------
-----------------------------------------------11111--------------------------------------------------------------------
-----------------------------------------------00000--------------------------------------------------------------------
------------------------------------------------------------------------------------------------------------------------
------------------------------------------------------------------------------------------------------------------------
------------------------------------------------------------------------------------------------------------------------
-----------------------------------------------11111--------------------------------------------------------------------
-----------------------------------------------00000--------------------------------------------------------------------
------------------------------------------------------------------------------------------------------------------------
------------------------------------------------------------------------------------------------------------------------
------------------------------------------------------------------------------------------------------------------------
------------------------------------------------------------------------------------------------------------------------
------------------------------------------------------------------------------------------------------------------------
-----------------------------------------------11111--------------------------------------------------------------------
-----------------------------------------------00000--------------------------------------------------------------------
------------------------------------------------------------------------------------------------------------------------
---------------------1111---------------------------------------------11------------------------------------------------
---------------------0000-----------1111------------------------------00------------------------1111--------------------
------------------------------------------------------------------------------------------------0000--------------------
------------------------------------------------------------------------------------------------0000--------------------
------------------------------------------------------------------------------------------------0000--------------------
111111111111111111111111111111111---------------111111111111111111------------111111111111111111000011111111111111111111
000000000000000000000000000000000-------00000000000000000000000000000000000000000000000000000000000000000000000000000000
